C 128,128,123
SO ./assets/textures/wall_blue.xpm
NO ./assets/textures/wall_wooden.xpm
F 82,82,250
WE ./assets/textures/wall_flag.xpm
EA ./assets/textures/wall_wooden.xpm

1111
1001
1001
1001
1001
1001
1011
1001
1101
1001
1011
1001
1101
1001
1011
1001
1101
1001
1011
1001
1101
1111
1111
1001
1011
1001
1101
1001
1011
1001
1101
1001
1011
1001
1101
1001
1011
1001
1101
10W1
1011
1001111
111111111