SO ./assets/textures/red.xpm
NO ./assets/textures/green.xpm

F 200,200,200
EA ./assets/textures/blue.xpm

C 82,92,40
WE ./assets/textures/yellow.xpm


        111111111
        111111111
          100001
         111111
111111111111111111111111                 111111111111111111111111111
             1111111111                   111111111111100000000000001
            100000000001                 100000000000000000000000001
            100000000001                100000000000000000000000001
            100000011111                1000S0000000000000000000011
            10000001                    1000000000000000000000001011
            10000001                    100000000000000000000000001
            100111001                    100000000000000000000000001
111111111111100100011111111111           100000000000000000000000001111111111
11000000000000000100000000000011          11111111111000000000000000000000000111
10000000000000000000000000000001          10000000000000000000000000000000001
10000000000000000000000000000001          10000000000000000000000000000000001
10000000000000000000000000000001          10000000000000000000000000000000001
10000000000000000000000000000001          10000000000000000000000000000000001
11111000000000000000000000000001          10000000000000000000000000000000001
10000000000000000000000000000001          10000000000000000000000000000000001
11111111111111111111111111111111          11111111111111111111111111111111111
11111111111111111111111111111111          1111111111111111111111
     100000000000000000000000011          1111111111111000000001
11111111111111111111111111111111          1111111111111111111111
11111









