NO ./assets/textures/graywall.xpm
SO ./assets/textures/wall_blue.xpm
WE ./assets/textures/wall_flag.xpm
EA ./assets/textures/wall_wooden.xpm

F 82,82,82

C 128,128,136

1111111111111111111111111
100000000011W000000000001
1011000001110000000000001
100100000000000000000000111111111
111111111011000001110000000000001
100000000011000001110111111111111
11110111111111011100000010001
11110111111111011101010000011
11000000110101011100000010001
10000000000000001100000010001
10000000000000001101010010001
1100000111010101111101111000111
11110111 1110101 101111010001
11111111 1111111 111111111111