NO ./assets/textures/ahegao0.xpm
SO ./assets/textures/ahegao1.xpm
WE ./assets/textures/ahegao2.xpm
EA ./assets/textures/ahegao3.xpm

C 235,90,131
F 246,11,21

  111111111111111111111111111111111111111111111111111111111
  100000000000000000000000000000000000000000000000000000001
  100000000000000000000000000000000000000000000000000000001
  100000000000000000000000000000000000000000000000000000001
11100000000000000000000000000000000000001111111111111111111
 1100000000000000000111110000000011111111
 1100000000000000000111110000000011111111
 1100000000000000000111110000000011111111
 1100000000000000000111110000000011111111
 1100000000000000000111110000000011111111
 1100000000000000000111110000000011111111
 1100000000000000000111110000000011111111
 1100000000000000000111110000000011111111
 1100000000000000000111110000000011111111
 1100000000000000000111110000000011111111
 110000000W000000000111110000000011111111
 1100000000000000000111110000000011111111
 1100000000000000000111110000000011111111
 1100000000000000000111110000000011111111
 1100000000000000000111110000000011111111
 1100000000000000000111110000000011111111
 1100000000000000000111110000000011111111
 1100000000000000000111110000000011111111
 1100000000000000000111110000000011111111
 1100000000000000000111110000000011111111
 1100000000000000000111110000000011111111
11100000000000000000111110000000011111111
1000000011111110000000000001111111
1000000111111110000000000001111111
10000001 10000000000000000000000011111
111111111110000000000000000111111111111111
111111111111111111111111111111111111111111
111111                              111111
100001                              100001
100001111111111111111111111111111111100001
100000000000000000000000000000000000000001
100001111111111111111111111111111111100001
100001                              100001
111111                              1111111
